####################################################################################################
#..............#,,,,,,,,,,,,,,,,,,,,,,,,,,,,,,,,,,,,,,,,,,,,,,,,,,,,,,,,,,,,,,,,,,,,,,,,,,,,,,,,,,,#
#..............#,,,,,,,,,,,,,,,,,,,,,,,,,,,,,,,,,,,,,,,,,,,,,,,,,,,,,,,,,,,,,,,,,,,,,,,,,,,,,,,,,,,#
#......,,.......,,,,,,,,,,,,,,,,,,,,,,,,,,,,,,,,,,,,,,,,,,,,,,,,,,,,,,,,,,,,,,,,,,,,,,,,,,,,,,,,,,,#
#......,,......###.###########.#####.##.#,,,,,,,,,,,,,,,,,,,,,,,,,,,,,,,,,,,,,,,,,,,,,,,,,,,,,,,,,,#
#.......,.#......#......................#,,,,,,,,,,,,,,,,,,,,,,,,,,,,,,,,,,,,,,,,,,,,,,,,,,,,,,,,,,#
#.......,......#.#......................#,,,,,,,,,,,,,,,,,,,,,,,.,..,.,,,,,,,,,,,,,,,,,,,,,,,,,,,,,#
#####.##,#######.#.....,,..##...........#,,,,,,,,,,,,,,,,,,,,,,,,.##.,,,,,,,,,,,,,,,,,,,,,,,,,,,,,.#
#.......,......#.#.....,,..##...........#,,,,,,,,,,,,,,,,,,,,,,,,.##.,,,,,,,,,,,,,,,,,,,,,,,,,,,,,,#
#.......,..............,,..##...........#,,,,,,,,,,,,,,,,,,,,,,,.,..,.,,,,,,,,,,,,,,,,,,,,,,,,,,,,,#
#.......,......#.#.....,,...............#,,,,,,,,,,,,,,,,,,,,,,,,,..,,,,,,,,,,,,,,,,,,,,,,,,,,,,,,,#
#.......,......#.#.......,,...............#,,,,,,,,,,,,,,,,,,,,,,,..,,,,,,,,,,,,,,,,,,,,,,,,,,,,,,,#
#.......,...........................................................,,,,,,,,,,,,,,,,,,,,,,,,,,,,,,,#
#.......,.......####...#####........................................,,,,,,,,,,,,,,,,,,,,,,,,,,,,,,,#
#,,#####,#,,,,,,#,,......############..##,,,,,,,,,,,,,,,,,,,,,,,,,,,,,,,,,,,,,,,,,,,,,,,,,,,,,,,,,,#
#,,,,,,,,,,,,,,,,,,......................,,,,,,,,,,,,,,,,,,,,,,,,,,,,,,,,,,,,,,,,,,,,,,,,,,,,,,,,,,#
########.############.##############################################################################
##..............#####.....#........................................................................#
##.########.###.#...###...........................................................................X#
#.............#.....#####..........................................................................#
#...######.......#........##########################################################################
###############..#######..##########################################################################
..............#############.........................................................................
....................................................................................................
....................................................................................................
....................................................................................................
....................................................................................................
....................................................................................................
....................................................................................................
....................................................................................................
....................................................................................................
....................................................................................................
....................................................................................................
....................................................................................................
....................................................................................................
....................................................................................................
....................................................................................................
....................................................................................................
....................................................................................................
....................................................................................................
....................................................................................................
....................................................................................................
....................................................................................................
....................................................................................................
....................................................................................................
....................................................................................................
....................................................................................................
....................................................................................................
....................................................................................................
...............................................###.#####............................................
...............................................#........##..........................................
...............................................#...###...##.........................................
...............................................#......#...#.........................................
...............................................#......#...#.........................................
...............................................#...####.###.........................................
...............................................#####................................................
....................................................................................................
....................................................................................................
....................................................................................................
....................................................................................................
....................................................................................................
....................................................................................................
....................................................................................................
....................................................................................................
....................................................................................................
....................................................................................................
....................................................................................................
....................................................................................................
....................................................................................................
....................................................................................................
....................................................................................................
....................................................................................................
....................................................................................................
....................................................................................................
....................................................................................................
....................................................................................................
....................................................................................................
....................................................................................................
....................................................................................................
....................................................................................................
....................................................................................................
....................................................................................................
....................................................................................................
....................................................................................................
....................................................................................................
....................................................................................................
....................................................................................................
....................................................................................................
....................................................................................................
....................................................................................................
....................................................................................................
....................................................................................................
....................................................................................................
....................................................................................................
....................................................................................................
....................................................................................................
....................................................................................................
....................................................................................................
....................................................................................................
....................................................................................................
